111111111111111111110
1C0000CCCC00000000PC1
1000101000000001C0010
1P001E100000000CCCC01
111111111111111111111
