111111111111111
1C0000000000001
100000000000001
1P00000000000E1
111111111111111
