111111111111111
111PCCCCCCCE001
111100000011111
111111000111C11
111111111111111