111111111
1111REPC1
111111111
111111111