11111011111
11000000001
1PEC0000001
11111111111