11111111
11CCCCC1
111000C1
11111E11
11111111