11111111
11PP1111
111CCC11
111111E1
11111111