111111111111111111
10000000PC00000001
1E0000000000000001
111111111111111111
