11111111
11PC0111
11011111
11111111
111111E1
11111111