1111111
1E11111
1111C01
11111P1
1111111