1111111
111P111
1111111
1111111
1EC1111
1111111